11111111111111111111111111111111111111111111111111
1P000000000000000000000000000000000000000000000001
10000000000000000000000000000000000000000000000001
11100000000001111000000000000000000000000000000001
10000000000000000000000000000000000000000000000001
10000C00000000000000000000000000000000000000000001
10111110000110000000000000000000000000000000000001
10000000000000000000000000000000000000000000000001
1000000000000000000000000000000000000C000000000001
10000000000000000000000000000000000000000000000001
10000000111111111111111111111111111111110000000001
10000000000000000000000000000000000000011100000001
10000000000000000000000000000000000000000111000001
100000000000000000000000000000000000000000011100S1
10000000000000000000000000000000000000000000011111
10000000000000000000000000000000000000000000000001
10000000000000000000000000000000000000000000000001
10000000000000000000000000000000000000000000000001
10000000000000000000000000000000000000000000000001
10000000000000000000000000000000000000000000000001
10000000000000000000000000000000000000000000000001
10000000000000000000000000000000000000000000000001
10000000000000000000000000000000000000000000000001
10000000000000000000000000000000000000000000000001
10000000000000000000000000000000000000000000000001
10000000000000000000000000000000000000000000000001
10000000000000000000000000000000000000000000000001
10000000000000000000000000000000000000000000000001
10000000000000000000000000000000000000000000000001
10000000000000000000000000000000000000000000000001
10000000000000000000000000000000000000000000000001
10000000000000000000000000000000000000000000000001
10000000000000000000000000000000000000000000000001
10000000000000000000000000000000000000000000000001
10000000000000000000000000000000000000000000000001
10000000000000000000000000000000000000000000000001
10000000000000000000000000000000000000000000000001
10000000000000000000000000000000000000000000000001
10000000000000000000000000000000000000000000000001
10000000000000000000000000000000000000000000000001
10000000000000000000000000000000000000000000000001
10000000000000000000000000000000000000000000000001
10000000000000000000000000000000000000000000000001
10000000000000000000000000000000000000000000000001
10000000000000000000000000000000000000000000000001
10000000000000000000000000000000000000000000000001
10000000000000000000000000000000000000000000000001
10000000000000000000000000000000000000000000000001
10000000000000000000000000000000000000000000000091
11111111111111111111111111111111111111111111111111